1111111111
1000000001
10001E1001
1000010011
100110C001
1001100001
1000P11111
1000001001
1000000001
1111111111
