1111111111
1000000001
10000E0001
1000000001
100000C001
1001100001
1000P00001
1000001001
1000000001
1111111111
