1111111111
1000000001
100010E001
1000C00001
100P000001
1000110001
10CC000001
1000C00011
1000000C01
1111111111
