111111
1P1C11
100011
1C0E11
111111
