1111111111
1000000001
10000E0001
1000000001
100000C001
1000110001
1000000011
1000001P01
1000000001
1111111111
