111111
1P1C11
100111
1C1E11
111111
