1111111
1000001
1000001
1000001
10C0001
1P00CE1
1000001
1000001
1000001
1111111
