1111111111
1000001001
100011E101
1000C10001
100P000111
1000110001
10CC000001
1000C00011
1000000C01
1111111111
