111111111111111111111111111111
1P0000000000000000000000000001
100011111110000000000000000001
100000000010001111000000000001
100000000010000000000000000001
1000000000100000000000000C0001
100011111110000000000000000001
100000000000000000111111111111
100000C00000000000000000000001
111111111111110000000000000001
1C0000000000000000000000000001
1E0000000000000000000000000001
100000000000111111111111111111
100000000000000000000000000001
111111111111111111111111111111
