111111
100001
10CP01
100E01
111111
