11111111111111111111111111111111111111111111111111
1P000000000000000000000000000000000000000000000001
10001111111000000000000000000000000000000000000001
10000000001000111100000000000000000000000000000001
10000000001000000000000000000000000000000000000001
1000000000100000000000000C000000000000000000000001
10001111111000000000000000000000000000000000000001
10000000000000000011111111111111111111110000000001
10000000000000000000000000000000000000000000000001
11111111111111000000000000000000000000000000000001
1C000000000000000000000000000000000000000000000001
10000000000000000000000000000000000000000000000001
10000000000011111111111111111111111111111111111111
10000000000000000000000000000000000000000000000001
10000000000000000000000000000000000000000000000001
11111111111111000000000000000000000000000000000001
1C000000000000000000000000000000000000000000000001
1E000000000000000000000000000000000000000000000001
10000000000011111111111111111111111111111111111111
11111111111111111111111111111111111111111111111111
