11111111111
1PCCCCCCCC1
1E1111111C1
111111111C1
1CCCCCCCCC1
1C111111111
1CCCCCCCCC1
111111111C1
111111111C1
1CCCCCCCCC1
1C111111111
11111111111
