111111111111111111111111111111111111111111111111111
1P00000000000000000C0000011111110000000000000000001
111111110111111111111000111000111110111111111000001
100000000000000000001000000000000000000000001000001
100111111111111111101111111101111111111111101111111
100000000000000000000000000000000000000000000000001
111111111101111111111111101111111111111110111111001
1000000000000000000C0000001000000000000000000000001
101111111111111111111000111110111111111111111110001
10000000000000000000000000000000000000000000000C001
111111110111111111111110111111111111110111111111001
100000000000000000000000000000000000000000000000001
111111111101111111111111101111111111111111111110001
10000000000000000000000000000000C000000000000000001
101111111111111111111000111111111111111111111110001
100000000000000000000000000000000000000000000000001
1111111111111111111111C1111111111111111111111111111
100000000000C00000000000000000000000000000000000001
101111111111111111111111111111111111111111111110001
100000000000000000000000000000000000000000000000001
100111111111111111111111111111111111011111111111111
100000000000000000000000000000000000000000000000001
101111111111111111111111111111111111111111111110001
100000000000000000000000000000000C00000000000000001
111111110111111111111111111111111111111111111111111
100000000000000000000000000000000000000000000000001
101111111111111111111111111111111111111111111110001
100000000000000000000000000000000000000000000000001
101111111111111111111111111111111111111111111110001
1000000000000000000C0000000000000000000000000000001
111111110111111111111111111111111111111111111111111
100000000000000000000000000000000000000000000000001
101111111111111111111111111111111111111111111110001
100000000000000000000000000000000000000000000000001
100111111111111111111111111111111111111111111111111
100000000000000000000000000000000000000000000000001
101111111111111111111111111111111111111111111110001
100000000000000000000000000000000000000000000000101
1C0000000000CCCCCCCCCCCCCCCCCCCCCCCCCCCCCCC0000CEC1
111111111111111111111111111111111111111111111111111
